1111111111111111111111
100C10000000C111001C11
1011101111111111111011
1000000P00000000000011
1111100000110111000011
10000000011000C1000011
1010000011000111000011
101000011E0001C0000011
1C10000111110111000011
1110000000110000000001
1000000000110000000001
1C11100000000000000001
1111111111111111111111
