111111111111111111111111111111111111111111111111
1CCCE1CCCCCCCCCCCCCCCC10CCC000000000000000000001
1C1111C11111111111111C1111C000000000000000000001
1CCCCCCCCCCCCCCCCCCCCCCCCC0000000000000000000001
1C1111C11C11111111C11C1111C000000000000000000001
1C1111C11C11111111C11C1111C000000000000000000001
1CCCCCC11CCCC11CCCC11CCCCCC000000000000000000001
111111C11111C11C11111C11111000000000000000000001
111111C11111C11C11111C11111000000000000000000001
111111C1CCCCCCCCCCCC1C11111000000000000000000001
111111C1C1111111111C1C11111000000000000000000001
111111CCCCC00000PCCCCC11111000000000000000000001
111111C1C1111CC1111C1C11111000000000000000000001
111111C1CCCCCCCCCCCC1C11111000000000000000000001
111111C1C1111111111C1C11111000000000000000000001
1CCCCCCCCCCCC11CCCCCCCCCCCC000000000000000000001
1C1111C11111C11C11111C1111C000000000000000000001
111111111111111111111111111111111111111111111111
111111111111111111111111111111111111111111111111
111111111111111111111111111111111111111111111111
111111111111111111111111111111111111111111111111
111111111111111111111111111111111111111111111111
111111111111111111111111111111111111111111111111
111111111111111111111111111111111111111111111111
