111111111111111111111111111111111111111111
1CCC01CCCCCCCCCCCCCCCC10CCC000000000001P01
1C1111C11111111111111C1111C000000000001C11
1CCCCCCCCCCCCCCCCCCCCCCCCC0000000000000001
1C1111C11C11111111C11C1111C000000000000001
1C1111C11C11111111C11C1111C000000000000001
1CCCCCC11CCCC11CCCC11CCCCCC000000000000001
111111C11111C11C11111C11111000000000000001
111111C11111C11C11111C11111000000000000001
111111C1CCCCCCCCCCCC1C11111000000000000001
111111C1C1111111111C1C11110000000000000001
111111CCCCC000000CCCCC11111000000000000001
111111C1C1111CC1111C1C11111000000000000001
111111C1CCCCCCCCCCCC1C11111000000000000001
111111C1C1111111111C1C11111000000000000001
10CCCCCCCCCCC11CCCCCCCCCCCC000000000000001
1C1111C11111C11C11111C1111C0000000000000E1
111111111111111111111111111111111111111111
