1111111111111111111111
1111111111P11111111111
1111111111C11111111111
1111111111C11111111111
1111111111C11111111111
1111111111C11111111111
111CCCCCCCCCCCCCCC1111
1111111111C11111111111
1111111111C11111111111
1111111111C11111111111
1111111111C11111111111
1111111111E11111111111
1111111111111111111111
