1111111111111111111111
111C111111CCCCCCCCP111
111C111111C11111111111
111C111111C11111111111
111C111111C11111111111
111C111111C11111111111
111CCCCCCCCCCCCCCC1111
1111111111C111111C1111
1111111111C111111C1111
1111111111C111111C1111
1111111111C111111C1111
11ECCCCCCCC111111C1111
1111111111111111111111
